original	corrected	confidence
EAP7928	EIP-7928	high
Def.2	DevNet 2	medium
ACDT	ACDT	high
ERPs	EIPs	high
DevNet1	DevNet 1	low
Definite2	DevNet 2	high
Definite 2	DevNet 2	high
DevNet2	DevNet 2	low
Definite	DevNet	high
definites	DevNets	high
REF	Reth	medium
Aragon	Erigon	high
BAL	BAL	low
GEF	Geth	high
BASO	Besu	high
Geff	Geth	high
Basu	Besu	high
BloatNet	BloatNet	low
Definite2	DevNet 2	high
Definite 2	DevNet 2	high
