original	corrected	confidence
EAP7928	EIP-7928	high
DevFlat	DevNet	high
MetaMind	Nethermind	high
Definite One	DevNet 1	high
Definite	DevNet	high
Alcadvs	All Core Devs	high
EAPs	EIPs	high
ERPs	EIPs	high
DEFNET	DevNet	high
Bezoo	Besu	high
Bezo	Besu	high
Netamind	Nethermind	high
Nethermind	Nethermind	low
Nethermine	Nethermind	high
FNET1	DevNet 1	high
e-transfer	ETH transfer	medium
Glamsterdam	Glamsterdam	low
Amsterdam	Glamsterdam	medium
Kabulus	Camille	medium
