original	corrected	confidence
glamsterum	Glamsterdam	high
Floadster	Lodestar	high
gloss	Gloas	medium
Gatsby funds	gas refunds	medium
Bell Definite2	BAL DevNet 2	high
Bell	BAL	high
Ball Defnet 2	BAL DevNet 2	high
Baldevna 2	BAL DevNet 2	high
DEFNET	DevNet	high
GED	Geth	high
Gus	Geth	medium
slotnum	SlotNum	medium
Aragon	Erigon	high
RETH	Reth	medium
EAPs	EIPs	high
EAP	EIP	high
Frisaka	Fusaka	high
GoAS	Gloas	medium
foulu	Fusaka	medium
Frusaka	Fusaka	high
