original	corrected	confidence
Oko Dev's	All Core Devs	medium
Opera Dev's	All Core Devs	medium
present	Prysm	medium
CLTs	CLs	medium
Krutosis	Kurtosis	high
bowel	BAL	medium
Bism	Besu	medium
Zoom	Besu	low
NGEM	engine	medium
Eragon	Erigon	high
Glaus	Glamsterdam	medium
Fulu	Fusaka	medium
gloss	Gloas	medium
sales side	CL side	medium
Hagota	Hegota	high
Haguta	Hegota	high
Grandin	Grandine	high
NoteStar	Lodestar	high
withdrawabilityDelay	withdrawability delay	low
